1111111111111111111111111111
1P000CCCCCCCCCCCCCCCCC000001
10C0011000111001110011100C01
101C00100000100001000010C101
1011001000111001110000101101
10100C10EEE010000100001001C1
1000011100111001110000100001
1CCCCCCCCCCCCCCCCCCCCCCCCCC1
1000CCCCCCCCCCCCCCCC0C000111
10C0011000111001110011100C01
101C00100000100001000010C101
1011001000111001110000101101
10100C10000010000100001001C1
10000111001110011100001000E1
1111111111111111111111111111