1111111111111111111111
1P00CCCC000000000000C1
100011110C0C0C0C0C00C1
110011110C0C0C0C0C0001
1000CCC00101010101CCC1
100011000000000001CCC1
1000000CCCCCCCCC01CCC1
1000CC01C1C1C1C10100E1
1111111111111111111111