11111111111111111
100CCCCCCCCC0CC01
100C1000001110001
10001CCCC0CC1CC01
1000101CCC1110001
10001111001CCC001
1PCCC010001110001
10CCCCCCCCCCCC0E1
11111111111111111